
SO               ./textures/wall70x70.xpm



EA        ./textures/floor70x70_1.xpm
C            006,060,060

NO         ./textures/s.xpm

F    151,155,166
WE ./textures/player_hack70x70_1.xpm


 111111111111111
1S11
 1001111111111111
  10011111100011111
   100111100100011111
    100111010110011111
    11001100011100111111
   11110011111100111111
   11111001111001111111
   11111100110011111111
   1111111001011111111
   111111110001111111
   1111111111111111