
SO               ./textures/wall70x70.xpm



EA        ./textures/floor70x70_1.xpm
C               000,000,000


NO         ./textures/tacos70x70.xpm
F    151,155,166
WE ./textures/player_hack70x70_1.xpm


        111111111111111111111111111111
        1000000000110010100000001
        1011000001110010100000001
        1001000000000000000000011
1111111110110000011100000110000001
100000000011000001110000000011111
1111011111111101110000S000001
1111000000000001110100010001
1100001111111101110000100001
1000001     10000001011000011111
1000001      11110100000000000001
1000101       100000010010111111
110000011111111111111000100001
11110111 1110101 101000000001
11111111 1111111 11100001111
1111111111111111111100000111
111111111111100000000000111
        1111111111110010111111111
        1000000000110000000000001
        1011000001110000000000001
        1001000000000000000000001
111111111011000001110000000000001
100000000011000001110000001111111
11110111111111011100000010001
11110000000000011101010010001
11000011111111011100000010001
1000001     100000001100000111111
1000001      11110000011000000001
1000101       1000000011010111111
11000001111111111111011110001
11110111 1110101 101111010001
11111111 1111111 111111111111
